{
  "row_heights": {
    "1": 23.25,
    "2": 18,
    "3": 18,
    "4": 18,
    "5": 18,
    "6": 18,
    "7": 18,
    "8": 18,
    "9": 18,
    "10": 18,
    "11": 18,
    "12": 18,
    "13": 18,
    "14": 18,
    "15": 18,
    "16": 18,
    "17": 18,
    "18": 18,
    "19": 18,
    "20": 18,
    "21": 18,
    "22": 18,
    "23": 18,
    "24": 18,
    "25": 18,
    "26": 18,
    "27": 18,
    "28": 18,
    "29": 18,
    "30": 18,
    "31": 33,
    "32": 18,
    "33": 36,
    "34": 18,
    "35": 18,
    "36": 18,
    "37": 18,
    "38": 18,
    "39": 18,
    "40": 18,
    "41": 18,
    "42": 18,
    "43": 18,
    "44": 18,
    "45": 18,
    "48": 18,
    "49": 18,
    "50": 18,
    "51": 18,
    "52": 18,
    "53": 18,
    "54": 18
  },
  "column_widths": {
    "A": 3.5,
    "B": 13,
    "C": 13,
    "D": 13,
    "E": 13,
    "F": 13,
    "G": 13,
    "H": 13,
    "I": 13,
    "J": 13,
    "K": 13,
    "L": 13,
    "M": 13,
    "N": 13,
    "O": 13,
    "P": 13,
    "Q": 13,
    "R": 13,
    "S": 13,
    "T": 13,
    "U": 13,
    "V": 13,
    "W": 13,
    "X": 4,
    "Y": 3.5,
    "Z": 13,
    "AA": 13,
    "AB": 13,
    "AC": 13,
    "AD": 13,
    "AE": 13,
    "AF": 13,
    "AG": 13,
    "AH": 13,
    "AI": 13,
    "AJ": 13,
    "AK": 13,
    "AL": 13,
    "AM": 13,
    "AN": 13,
    "AO": 13,
    "AP": 13,
    "AQ": 13,
    "AR": 13,
    "AS": 13,
    "AT": 13,
    "AU": 13,
    "AV": 13,
    "AW": 13,
    "AX": 13,
    "AY": 13,
    "AZ": 13,
    "BA": 13,
    "BB": 13,
    "BC": 13,
    "BD": 13,
    "BE": 13,
    "BF": 13,
    "BG": 13,
    "BH": 13
  }
}